%%%%%%%%%%%%%%%%%%%%%%%%%%%%%%%%%%%%%
%.      %                         %.%
%         %%%%% % %%% %%% %%%%%%% % %
%       %       % %     %     % %   %
%%%%% %%%%% %%% % % % %%% %%%%% % %%%
%   % % % %   % % % %   % %     %   %
% %%% % % % %%% %%%%% %%% % %%% %%% %
%       %     %   %   %     % % %   %
%%% %%%%%%%%% %%%%%%% %%% %%% % % % %
%             %       % %   %     % %
% % %%%%% % %%% % % %%% % %%% %%% % %
% % %     % % % % %     %   % % % % %
% % % %%%%%%% % %%%%%%%%% %%% % %%% %
% % % %     %   %     %     %   %   %
%%% %%% % %%%%% %%%%% %%% %%% %%%%% %
%     % %               % %   % % % %
% % % % % % % % % %%% %%% % % % % % %
% % % % % % % % % % % %   % % %     %
% % %%%%% %%% %%% %%% % %%% %%% %%%%%
%       %   %   % % % %       % %   %
% %%% % %   %   % %%% %%%%%%%%% % %%%
%   % %                   %   % %   %
% %%% %%%%%%%%%%%%%%%%%%%%% % % %%% %
% %                         %       %
% % % %%%%% %%% % % % % %%%%%%% %%%%%
% % %   %     % % % %       %   % % %
% % %%% %%% % % % %%%%%%%%% %%% % % %
% %   % %   % % %   % %   % % %     %
% %%% %%% %%% % %%% % % %%%%% %%%%%%%
%      P%   %     %       %   % %   %
%%% % %%%%% %%%%% %%% %%% % %%% % %%%
% % % % % % % %     % %   % %   % % %
% % %%% % % % % %%%%%%%%% % % % % % %
%       %                     %     %
% %   % %%% %%% %%%%%%% %%% %%% %%% %
%.%   %       %           %     %  .%
%%%%%%%%%%%%%%%%%%%%%%%%%%%%%%%%%%%%%